{
  "name": "The get down",
  "winningPoint": {
	"x": 0,
	"y": 2,
	"z": 3
  },
  "map": [
	  [
		[1, 0, 1, 0, 1, 0, 1, 0, 1, 0],
		[0, 0, 0, 0, 0, 0, 0, 0, 0, 0],
		[0, 0, 0, 0, 0, 0, 0, 0, 0, 0],
		[0, 1, 1, 1, 1, 1, 1, 1, 1, 1]
	  ],
	  [
		[0, 0, 0, 0, 0, 0, 0, 0, 0, 0],
		[0, 0, 0, 0, 0, 0, 0, 0, 0, 1],
		[0, 0, 0, 0, 0, 0, 0, 0, 0, 1],
		[0, 0, 0, 0, 0, 0, 0, 0, 0, 0]
	  ],
	  [
		[0, 0, 0, 0, 0, 0, 0, 0, 0, 0],
		[1, 0, 0, 0, 0, 0, 0, 0, 0, 0],
		[1, 0, 0, 0, 0, 0, 0, 0, 0, 0],
		[9, 0, 0, 0, 0, 0, 0, 0, 0, 0]
	  ]
	]
}